app_reviews_com$wire	tsv/com.wire.csv
app_reviews_com$simplemobiletools$calendar	tsv/com.simplemobiletools.calendar.csv
app_reviews_dev$ukanth$ufirewall	tsv/dev.ukanth.ufirewall.csv
app_reviews_net$nurik$roman$muzei	tsv/net.nurik.roman.muzei.csv
app_reviews_com$ichi2$anki	tsv/com.ichi2.anki.csv
app_reviews_com$fsck$k9	tsv/com.fsck.k9.csv
app_reviews_com$google$samples$apps$iosched	tsv/com.google.samples.apps.iosched.csv
app_reviews_org$videolan$vlc	tsv/org.videolan.vlc.csv
app_reviews_cgeo$geocaching	tsv/cgeo.geocaching.csv
app_reviews_com$prey	tsv/com.prey.csv
app_reviews_fm$last$android	tsv/fm.last.android.csv
app_reviews_org$stepic$droid	tsv/org.stepic.droid.csv
app_reviews_org$mariotaku$twidere	tsv/org.mariotaku.twidere.csv
app_reviews_com$simplemobiletools$gallery	tsv/com.simplemobiletools.gallery.csv
app_reviews_com$tweetlanes$android	tsv/com.tweetlanes.android.csv
app_reviews_de$ph1b$audiobook	tsv/de.ph1b.audiobook.csv
app_reviews_org$kde$kdeconnect_tp	tsv/org.kde.kdeconnect_tp.csv
app_reviews_de$danoeh$antennapod	tsv/de.danoeh.antennapod.csv
app_reviews_com$google$zxing$client$android	tsv/com.google.zxing.client.android.csv
app_reviews_org$gnucash$android	tsv/org.gnucash.android.csv
app_reviews_org$wikipedia	tsv/org.wikipedia.csv
app_reviews_com$renard$ocr	tsv/com.renard.ocr.csv
app_reviews_org$thoughtcrime$securesms	tsv/org.thoughtcrime.securesms.csv
app_reviews_com$habitrpg$android$habitica	tsv/com.habitrpg.android.habitica.csv
app_reviews_com$achep$acdisplay	tsv/com.achep.acdisplay.csv
app_reviews_org$connectbot	tsv/org.connectbot.csv
app_reviews_org$telegram$messenger	tsv/org.telegram.messenger.csv
app_reviews_com$moez$QKSMS	tsv/com.moez.QKSMS.csv
app_reviews_org$geometerplus$zlibrary$ui$android	tsv/org.geometerplus.zlibrary.ui.android.csv
app_reviews_nickrout$lenslauncher	tsv/nickrout.lenslauncher.csv
app_reviews_com$asksven$betterbatterystats	tsv/com.asksven.betterbatterystats.csv
app_reviews_com$owncloud$android	tsv/com.owncloud.android.csv
app_reviews_com$mapswithme$maps$pro	tsv/com.mapswithme.maps.pro.csv
app_reviews_com$klinker$android$twitter_l	tsv/com.klinker.android.twitter_l.csv
app_reviews_com$duckduckgo$mobile$android	tsv/com.duckduckgo.mobile.android.csv
app_reviews_com$battlelancer$seriesguide	tsv/com.battlelancer.seriesguide.csv
app_reviews_org$wordpress$android	tsv/org.wordpress.android.csv
app_reviews_com$github$shadowsocks	tsv/com.github.shadowsocks.csv
app_reviews_jackpal$androidterm	tsv/jackpal.androidterm.csv
app_reviews_com$catchingnow$tinyclipboardmanager	tsv/com.catchingnow.tinyclipboardmanager.csv
